                                                                             
                   @                                           @             
    ####################################       ##############################
                                                 #       @                   
                   @                             #                           
################################       ###################################   
                                                                             
                                                                             
  ####################################       #############################   
                             #                                #              
                     @       #                                #              
##############################       ###################################    #
                                                                             
                                                                             
###################################       ##############################    #
                                            #            @                   
    @                                       #                                
###########################       ###################################    ####
                                                                             
          @                                                                  
###############################       ###############################    ####
               @                      #                @                     
                                      #                                      
